Machine,Job,Product,Operation,Start,Duration,Completion
0,0,enzyme0,0,0,8,8
1,3,enzyme3,0,0,4,4
2,1,enzyme1,0,0,3,3
3,2,enzyme2,0,0,3,3
4,5,enzyme5,0,0,8,8
8,2,enzyme2,1,3,3,6
3,3,enzyme3,1,5,6,11
2,4,enzyme4,0,6,5,11
5,0,enzyme0,1,8,4,12
8,5,enzyme5,1,10,3,13
6,4,enzyme4,1,11,4,15
7,3,enzyme3,2,11,6,17
5,1,enzyme1,1,14,2,16
8,4,enzyme4,2,15,7,22
7,0,enzyme0,2,20,4,24
