Machine,Job,Product,Operation,Start,Duration,Completion
0,4,enzyme4,0,0,5,5
1,3,enzyme3,0,0,4,4
2,0,enzyme0,0,0,8,8
4,2,enzyme2,0,0,3,3
5,5,enzyme5,0,0,8,8
3,3,enzyme3,1,4,6,10
4,4,enzyme4,1,7,4,11
8,5,enzyme5,1,8,3,11
2,1,enzyme1,0,9,3,12
7,3,enzyme3,2,10,6,16
5,0,enzyme0,1,12,4,16
6,1,enzyme1,1,12,2,14
8,0,enzyme0,2,16,4,20
7,4,enzyme4,2,18,7,25
8,2,enzyme2,1,22,3,25
